		a: "Account",
		ac: "Alert Count",
		acg: "Alert Count Group",
		amr: "Auto Margin Replenishment",
		b: "Book",
		bcc: "Blind Carbon Copy",
		c: "Cancel / Close",
		cbr: "Callback Rate",
		cc: "Carbon Copy",
		cm: "Cancel / Close Maximum",
		cmo: "Cancel / Close Maximum Order",
		cot: "Close On Trigger",
		d: "Disabled",
		delay: "Delay",
		dt: "Date/Time",
		e: "Exchange",
		f: "Fee",
		fgsl: "Fixed Guaranteed Stop Loss",
		fp: "Fixed Price",
		fpx: "Fixed Trigger Price",
		fsl: "Fixed Stop Loss",
		ftp: "Fixed Take Profit",
		fts: "Fixed Trailing Stop",
		gsl: "Guaranteed Stop Loss",
		h: "Hidden/Iceberg",
		l: "Leverage",
		lt: "Leverage Type",
		oco: "One Cancels the Other",
		p: "Price",
		ps: "Price Source",
		px: "Trigger Price",
		pxs: "Trigger Price Source",
		q: "Quantity",
		ro: "Reduce Only",
		s: "Symbol",
		sl: "Stop Loss",
		t: "order Type",
		testing: "Testing",
		tp: "Take Profit",
		ts: "Trailing Stop",
		u: "Unit",
		v: "Version",
		w: "Wallet",
		y: "Yield",